TTPPPTTTTTTTTTTTTTTTT
TTPPPTTTTTTTTTTTTTTTT
TTPPPTTTTTTTTTTTTTTTT
TTPPPTTTTTTTTPPPPTTTT
TTPPPTTTTTTTPPPPPPTTT
TTPPPTTTTTTPPPPPPPPTT
TTPPPTTTTTTPPPTTPPPTT
TTPPPTTTTTTPPPTTPPPTT
TTPPPTTTTTTPPPTTPPPTT
TTPPPTTTTTTPPPTTPPPTT
TTTPPPTTTTPPPTTTPPPTT
TTTTPPPPPPPPTTTTPPPTT
TTTTTPPPPPPTTTTTPPPTT
TTTTTTPPPPTTTTTTPPPTT
TTTTTTTTTTTTTTTPPPPTT
TTTTTTTTTTTTTTPPPPTTT
PPPPPPPPPPPPPPPPPTTTT
PPPPPPPPPPPPPPPPTTTTT
PPPPPPPPPPPPPPPTTTTTT
TTTTTTTTTTTTTTTTTTTTT
TTTTTTTTTTTTTTTTTTTTT