TTPPPTTTTTTTTTTTTTTTT
TTPPPTTTTTTTTTTTTTTTT
TTPPPTTTTPPPPPPPPPPTT
TTPPPTTTTPPPPPPPPPPTT
TTPPPTTTTPPPPPPPPPPTT
TTPPPTTTTPPPTTTTPPPTT
TTPPPTTTTPPPTTTTPPPTT
TTPPPTTTTPPPTTTTPPPTT
TTPPPTTTTPPPTTTTPPPTT
TTPPPTTTTPPPTTTTPPPTT
TTPPPPPPPPPPTTTTPPPTT
TTPPPPPPPPPPTTTTPPPTT
TTPPPPPPPPPPTTTTPPPTT
TTTTTTTTTTTTTTTTPPPTT
TTTTTTTTTTTTTTTTPPPTT
PPPPPPPPPPPPPPPPPPPTT
PPPPPPPPPPPPPPPPPPPTT
PPPPPPPPPPPPPPPPPPPTT
TTTTTTTTTTTTTTTTTTTTT
TTTTTTTTTTTTTTTTTTTTT